also remove image=同时删除镜像
Apply=应用
Are you sure=你确定吗？
Cancel=取消
checking=查看
Completely REMOVE=完全删除
Console=控制台
day=天
days=天
disk image and definition=磁盘映像和定义
Disks=磁盘
Done=完成
Edit=编辑
Execution error=执行错误
Force Stop=强制停止
Hibernate=休眠
Log for=Log for:
log=日志
Logs=日志
More Info=详细信息
No=不
OK=好
Ok=好
Pause=暂停
Proceed=继续
Project Page=项目页面
Remove container=删除容器
Remove definition=删除定义
Remove image=删除映像
Remove VM=删除虚拟机
Remove=删除
Restart=重新启动
Resume=摘要
Start=开始
Stop=停止
Support=支持
Update container=更新容器
Update=更新
Updating all Containers=更新所有容器
Updating the container=更新这个容器
VNC Remote=VNC远程
WebUI=Web界面
Yes, delete it=是的，删除它!
Yes, update it=是的，更新它!
Yes=是的

; footer messages
Array Starting=阵列启动中
Array Stopping=阵列停止中
Mounting disks=安装磁盘
Spinning up all drives=唤醒所有磁盘
Starting services=开启服务项目
Stopping services=关闭服务项目
Unmounting disks=磁盘被卸载
Autostart disabled=禁用自动启动
Missing encryption key=没有加密密钥
Opening encrypted volumes=打开加密的卷
